
R 1000 4566
NO./textures/wall_2.xpm 

S./textures/sprite_2.xpm

F 0, 255, 65
C 88, 23, 255

WE ./textures/wall_2.xpm    
EA./textures/wall_2.xpm
SO   ./textures/wall_2.xpm

                  1111111
                  1110001
                  1110001
                  1110001
1111111111111111111110001
          10000000000001
          10000000000001
          10000000000001
          10000000000001
111111111110000000000001
10000000000000111111111
11111000000000000000001  111
     1000000000011111111
     1000000000011
     1000000000011111111
     1111111111000111111111111111111
        11111100200000000000111111111
        1000200020000001111111
       1000020000000111111111  11111
      1111111110000000000000011111111
      1000000000000000000000001000011111                111
      10202020000000000000000000110001111
      1000222W00200111111000000001111111111
      1000020000110011000000000001
      102000021111110000000001111111
    111111111111111111111111111