R    800     600
SO   ./textures/wood.xpm
NO ./textures/wall_2.xpm
WE ./textures/wall_1.xpm
EA ./textures/wall_3.xpm
S ./textures/sprite_1.xpm

F 66,155,68
C 88,118,130

11111111111111
10000000000001
10000000000000111111111
11111000000000000000001 111
     1000000000011111111
     1000000000011
     1000000000011111111
     1111111111000111111111111111111
        11111100000000000000111111111
        1000000000000001111111
        100000000000011111111   111
      111111111000000000000001
      1000000000000000000000001                   111
      10000200000000S0000000011
      1000000000010000000000011
      10000000011111100000000111
      100000000110011000000000001
      100000000111111000000000111
    111111111111111111111111111