
R  600 450
NO  ./textures/wall_2.xpm   
WE ./textures/wall_1.xpm    
EA ./textures/wall_3.xpm
SO   ./textures/wood.xpm
S ./textures/sprite_3.xpm
F 66, 155,68
C 88, 23, 130

                  1111111
                  1110001
                  1110001
                  1110001
1111111111111111111110001
          10000000000001
          10000000000001
          10000000000001
          10000000000001
111111111110000000000001
10000000000000111111111
11111000000000000000001  111
     1000000000011111111
     1000000000011
     1000000000011111111
     1111111111000111111111111111111
        11111100200000000000111111111
        1000200020000001111111
       1000020000000111111111  11111
      1111111110000000000000011111111
      1000000000000000000000001000011111                111
      102000000000000000000000110001111
      12200N000001000000000001111111011
      122000000111111000000001111111111
      102000000110011000000000001
      102000000111111000000000111
    111111111111111111111111111