
NO      ./textures/wall_2.xpm   
WE ./textures/wall_1.xpm    
EA ./textures/wall_3.xpm
R  900 700   
S ./textures/sprite_1.xpm
SO   ./textures/wood.xpm
F 66, 155,68
C 88, 118, 130

                  1111111
                  1110001
                  1110001
                  1110001
1111111111111111111110001
          10000000000001
          10000000000001
          10000000000001
          10000000000001
111111111110000000000001
10000000000000111111111
11111000000000000000001  111
     1000000000011111111
     1000000000011
     1000000000011111111
     1111111111000111111111111111111
        11111100000000000000111111111
        1000000000000001111111
       1000000000000111111111  111
      111111111000N00000000001
      1000000000000000000000001                   111
      10200000000000000000000011
      1220000000010000000000011
      12200000011111100000000111
      102000000110011000000000001
      102000000111111000000000111
    111111111111111111111111111