R 400 400

NO textures/wall_1.xpm
SO textures/wall_2.xpm
EA ./path_to_the_east_texture
WE ./path_to_the_west_texture

S textures/sprite_1.xpm
F 184,113,39
C 51,198,227

111111111
100000111
102000211
100000211
10000001
100N0001
11111111