R 1100 800
SO ./textures/wood.xpm
NO ./textures/wood2.png
WE ./textures/wall_1.xpm
EA ./textures/wall_3.png
S ./textures/sprite_1.png
F 66,155,86
C 88,118,230

1111111111111111111
1000000000000000001
1000000200000000021
1000000000000000021
10E0000000000000021
1000000000000000021
1000002000000000001
1111111111111111111